number,name,kor,eng,math,total,avg,rank,c_date
1,Sonny,87,58,64,209,69,0,2024-04-10
2,Kellen,59,51,50,160,53,0,2024-04-14
3,Ronald,57,54,71,182,60,0,2024-04-18
4,Engelbert,86,50,78,214,71,0,2024-04-11
5,Delainey,69,88,81,238,79,0,2024-04-17
6,Adham,99,78,97,274,91,0,2024-04-22
7,Pat,71,98,84,253,84,0,2024-04-14
8,Maria,62,54,100,216,72,0,2024-04-11
9,Reilly,65,98,84,247,82,0,2024-04-11
10,Bordie,53,73,76,202,67,0,2024-04-19
11,Jessa,68,95,79,242,80,0,2024-04-14
12,Isabel,57,54,98,209,69,0,2024-04-17
13,Daniella,57,61,94,212,70,0,2024-04-13
14,Blaine,64,71,52,187,62,0,2024-04-13
15,Selina,86,73,80,239,79,0,2024-04-18
16,Brittany,86,95,53,234,78,0,2024-04-12
17,Teddi,99,78,64,241,80,0,2024-04-10
18,Julianna,76,72,94,242,80,0,2024-04-11
19,Lovell,79,92,77,248,82,0,2024-04-20
20,Ambrose,63,95,87,245,81,0,2024-04-15
21,Gan,58,71,53,182,60,0,2024-04-20
22,Lucia,84,91,65,240,80,0,2024-04-13
23,Marvin,81,57,85,223,74,0,2024-04-21
24,Nahum,92,67,56,215,71,0,2024-04-14
25,Madeline,74,65,92,231,77,0,2024-04-13
26,Tybie,86,92,67,245,81,0,2024-04-22
27,Margo,93,76,82,251,83,0,2024-04-21
28,Patsy,73,56,99,228,76,0,2024-04-19
29,Feodor,72,84,89,245,81,0,2024-04-11
30,Hamil,52,78,79,209,69,0,2024-04-12
31,Clemmie,100,55,53,208,69,0,2024-04-16
32,Christin,52,86,99,237,79,0,2024-04-23
33,Myrvyn,91,52,68,211,70,0,2024-04-17
34,Davita,84,85,54,223,74,0,2024-04-11
35,Dorey,98,90,69,257,85,0,2024-04-14
36,Anthiathia,67,85,83,235,78,0,2024-04-16
37,Artemus,93,89,88,270,90,0,2024-04-13
38,Maybelle,77,84,88,249,83,0,2024-04-23
39,Maurizia,60,94,51,205,68,0,2024-04-20
40,Henderson,82,59,83,224,74,0,2024-04-10
41,Christyna,64,55,62,181,60,0,2024-04-15
42,Valry,66,93,68,227,75,0,2024-04-14
43,Roch,58,75,80,213,71,0,2024-04-19
44,Cathie,96,51,78,225,75,0,2024-04-23
45,Donielle,73,71,61,205,68,0,2024-04-18
46,Curtis,68,82,64,214,71,0,2024-04-15
47,Celestyn,63,73,63,199,66,0,2024-04-22
48,Sukey,51,74,71,196,65,0,2024-04-21
49,Conny,63,83,70,216,72,0,2024-04-22
50,El,86,92,54,232,77,0,2024-04-12
51,Filide,87,56,59,202,67,0,2024-04-16
52,Ashil,67,91,67,225,75,0,2024-04-22
53,Dotti,68,96,94,258,86,0,2024-04-19
54,Fara,83,76,50,209,69,0,2024-04-12
55,Minne,98,51,60,209,69,0,2024-04-19
56,Shari,64,86,80,230,76,0,2024-04-18
57,Nickolas,66,91,100,257,85,0,2024-04-15
58,Gordan,85,93,91,269,89,0,2024-04-17
59,Torie,93,62,85,240,80,0,2024-04-22
60,Virgie,98,89,95,282,94,0,2024-04-18
61,Silvester,59,77,89,225,75,0,2024-04-21
62,Hollyanne,66,73,54,193,64,0,2024-04-21
63,Curry,99,54,64,217,72,0,2024-04-15
64,Randee,81,71,93,245,81,0,2024-04-19
65,Mohandis,98,96,81,275,91,0,2024-04-22
66,Leandra,92,93,97,282,94,0,2024-04-19
67,Christye,95,97,69,261,87,0,2024-04-13
68,Sibel,65,62,77,204,68,0,2024-04-16
69,Dorian,94,74,52,220,73,0,2024-04-13
70,Thaddeus,91,87,80,258,86,0,2024-04-15
71,Jewelle,63,95,67,225,75,0,2024-04-23
72,Grannie,56,62,81,199,66,0,2024-04-17
73,Miof mela,51,60,78,189,63,0,2024-04-20
74,Tyler,79,75,67,221,73,0,2024-04-19
75,Fawne,65,97,95,257,85,0,2024-04-19
76,Lavina,69,86,71,226,75,0,2024-04-18
77,Tammie,66,67,56,189,63,0,2024-04-16
78,Towny,83,56,65,204,68,0,2024-04-15
79,Cedric,59,85,70,214,71,0,2024-04-18
80,Yurik,57,67,58,182,60,0,2024-04-19
81,Daune,61,50,62,173,57,0,2024-04-20
82,Fernando,97,95,93,285,95,0,2024-04-10
83,Sebastian,79,92,85,256,85,0,2024-04-18
84,Viviene,92,58,96,246,82,0,2024-04-10
85,Thorstein,75,70,82,227,75,0,2024-04-14
86,Marina,74,88,71,233,77,0,2024-04-19
87,Eve,68,80,83,231,77,0,2024-04-20
88,Bell,87,69,99,255,85,0,2024-04-22
89,Joby,58,54,52,164,54,0,2024-04-10
90,Ashien,65,94,100,259,86,0,2024-04-18
91,Kaleb,55,92,89,236,78,0,2024-04-21
92,Agnese,64,97,93,254,84,0,2024-04-13
93,Hobart,78,62,89,229,76,0,2024-04-19
94,Alta,76,82,81,239,79,0,2024-04-11
95,Horatius,80,53,92,225,75,0,2024-04-14
96,Edith,58,82,73,213,71,0,2024-04-18
97,Torr,67,65,57,189,63,0,2024-04-15
98,Klara,80,89,69,238,79,0,2024-04-22
99,Maximo,63,92,63,218,72,0,2024-04-15
100,Ryley,65,91,84,240,80,0,2024-04-11
101,Jacintha,97,71,87,255,85,0,2024-04-18
102,Faina,98,51,51,200,66,0,2024-04-18
103,Hetti,83,99,89,271,90,0,2024-04-21
104,Vivian,81,82,66,229,76,0,2024-04-21
105,Hazel,95,75,59,229,76,0,2024-04-16
106,Tucky,77,90,79,246,82,0,2024-04-21
107,Jacquenette,84,93,79,256,85,0,2024-04-17
108,Lacy,93,85,50,228,76,0,2024-04-10
109,Zaneta,50,84,59,193,64,0,2024-04-21
110,Brandea,79,67,51,197,65,0,2024-04-18
111,Jayson,72,92,59,223,74,0,2024-04-16
112,Mozes,76,78,96,250,83,0,2024-04-10
113,Bartie,91,93,56,240,80,0,2024-04-20
114,Curcio,84,67,50,201,67,0,2024-04-12
115,Reuven,55,94,75,224,74,0,2024-04-22
116,Martin,74,63,63,200,66,0,2024-04-22
117,Melvin,98,89,51,238,79,0,2024-04-21
118,Joane,83,75,61,219,73,0,2024-04-17
119,Siouxie,93,74,88,255,85,0,2024-04-12
120,Clemence,60,93,67,220,73,0,2024-04-22
121,Analiese,92,67,99,258,86,0,2024-04-12
122,Tobit,65,51,54,170,56,0,2024-04-20
123,Fabiano,55,96,61,212,70,0,2024-04-20
124,Papageno,97,88,59,244,81,0,2024-04-10
125,Lu,87,67,88,242,80,0,2024-04-21
126,Carmelina,79,52,75,206,68,0,2024-04-15
127,Pet,90,61,82,233,77,0,2024-04-18
128,Rollo,100,50,81,231,77,0,2024-04-14
129,Rebbecca,72,85,53,210,70,0,2024-04-14
130,Thaxter,53,88,84,225,75,0,2024-04-22
131,Meade,70,67,60,197,65,0,2024-04-13
132,Morganica,51,98,77,226,75,0,2024-04-22
133,Sarina,82,86,56,224,74,0,2024-04-15
134,Britta,93,58,99,250,83,0,2024-04-17
135,Darla,69,69,66,204,68,0,2024-04-11
136,Babs,84,52,66,202,67,0,2024-04-21
137,Neddy,94,88,51,233,77,0,2024-04-19
138,Justinn,94,78,91,263,87,0,2024-04-19
139,Kore,97,93,71,261,87,0,2024-04-22
140,Norbert,50,91,61,202,67,0,2024-04-20
141,Olivier,69,79,86,234,78,0,2024-04-16
142,Vincents,87,73,74,234,78,0,2024-04-10
143,Jule,84,68,93,245,81,0,2024-04-22
144,Wallie,61,52,75,188,62,0,2024-04-14
145,Ines,96,93,97,286,95,0,2024-04-14
146,Ginevra,95,99,51,245,81,0,2024-04-17
147,Calida,50,70,50,170,56,0,2024-04-20
148,Sandie,92,59,88,239,79,0,2024-04-10
149,Giraud,100,71,98,269,89,0,2024-04-14
150,Alta,77,77,53,207,69,0,2024-04-11
151,Mitchael,57,87,92,236,78,0,2024-04-20
152,Cointon,87,74,56,217,72,0,2024-04-17
153,Wait,64,67,63,194,64,0,2024-04-21
154,Claudius,82,61,85,228,76,0,2024-04-13
155,Barn,74,80,93,247,82,0,2024-04-14
156,Francyne,77,55,88,220,73,0,2024-04-12
157,Rebecca,89,50,85,224,74,0,2024-04-15
158,Sydel,66,57,52,175,58,0,2024-04-21
159,Roderic,96,79,86,261,87,0,2024-04-10
160,Orville,91,85,79,255,85,0,2024-04-13
161,Dylan,92,92,57,241,80,0,2024-04-21
162,Daile,58,84,99,241,80,0,2024-04-19
163,Jenelle,87,69,71,227,75,0,2024-04-18
164,Andros,56,95,52,203,67,0,2024-04-21
165,Kesley,53,88,87,228,76,0,2024-04-22
166,Corey,59,76,76,211,70,0,2024-04-14
167,Lani,53,75,69,197,65,0,2024-04-20
168,Claudette,98,75,89,262,87,0,2024-04-10
169,Idalina,99,85,50,234,78,0,2024-04-20
170,Rosemaria,52,83,81,216,72,0,2024-04-17
171,Denna,77,57,91,225,75,0,2024-04-14
172,Dorry,95,89,57,241,80,0,2024-04-17
173,Maddi,99,74,65,238,79,0,2024-04-11
174,Cari,71,64,97,232,77,0,2024-04-19
175,Cecil,85,85,74,244,81,0,2024-04-14
176,Zach,50,84,74,208,69,0,2024-04-20
177,Kenny,79,53,98,230,76,0,2024-04-12
178,Karen,82,73,56,211,70,0,2024-04-12
179,Denna,80,67,89,236,78,0,2024-04-17
180,Rip,75,52,86,213,71,0,2024-04-23
181,Guinna,85,78,85,248,82,0,2024-04-11
182,Raphael,93,73,55,221,73,0,2024-04-17
183,Jobie,79,57,75,211,70,0,2024-04-15
184,Brandyn,70,65,91,226,75,0,2024-04-22
185,Isak,72,59,81,212,70,0,2024-04-12
186,Isaak,93,83,82,258,86,0,2024-04-20
187,Wylma,53,86,80,219,73,0,2024-04-12
188,Adore,58,71,66,195,65,0,2024-04-18
189,Mark,53,53,58,164,54,0,2024-04-22
190,Dud,97,71,82,250,83,0,2024-04-19
191,Gerrie,54,61,93,208,69,0,2024-04-21
192,Drucy,56,92,61,209,69,0,2024-04-17
193,Pail,79,60,55,194,64,0,2024-04-10
194,Nestor,89,92,77,258,86,0,2024-04-20
195,Rachelle,65,50,96,211,70,0,2024-04-23
196,Vinita,86,96,57,239,79,0,2024-04-20
197,Rozalin,66,55,77,198,66,0,2024-04-10
198,Margot,83,88,72,243,81,0,2024-04-18
199,Dione,65,85,51,201,67,0,2024-04-16
200,Audre,70,70,57,197,65,0,2024-04-22
201,Patrick,68,95,63,226,75,0,2024-04-23
202,Drud,92,81,65,238,79,0,2024-04-20
203,Viviene,74,86,87,247,82,0,2024-04-13
204,Raddy,95,71,66,232,77,0,2024-04-14
205,Darice,91,54,81,226,75,0,2024-04-18
206,Roscoe,67,57,87,211,70,0,2024-04-14
207,Gwenora,90,53,97,240,80,0,2024-04-18
208,Ricky,66,56,70,192,64,0,2024-04-12
209,Ileane,88,91,85,264,88,0,2024-04-18
210,Merralee,77,68,74,219,73,0,2024-04-22
211,Jackson,59,98,61,218,72,0,2024-04-19
212,Jarrod,95,83,58,236,78,0,2024-04-12
213,Samuele,69,62,69,200,66,0,2024-04-11
214,Jecho,90,88,60,238,79,0,2024-04-12
215,Jordon,93,60,92,245,81,0,2024-04-19
216,Paten,82,99,56,237,79,0,2024-04-23
217,Aimee,69,90,53,212,70,0,2024-04-22
218,Clarissa,65,57,75,197,65,0,2024-04-13
219,Athena,89,93,93,275,91,0,2024-04-11
220,Hurley,54,51,87,192,64,0,2024-04-11
221,Stanton,74,84,54,212,70,0,2024-04-12
222,Donnell,98,72,76,246,82,0,2024-04-11
223,Syman,60,98,96,254,84,0,2024-04-20
224,Neille,84,77,93,254,84,0,2024-04-13
225,Jefferson,99,81,64,244,81,0,2024-04-13
226,Amalle,76,76,51,203,67,0,2024-04-13
227,Sayer,86,96,65,247,82,0,2024-04-20
228,Barbette,85,61,84,230,76,0,2024-04-20
229,Gardiner,94,99,62,255,85,0,2024-04-20
230,Franny,65,50,65,180,60,0,2024-04-11
231,Vitoria,59,97,59,215,71,0,2024-04-21
232,Tricia,66,81,83,230,76,0,2024-04-23
233,Weider,73,67,63,203,67,0,2024-04-13
234,Libbie,59,64,72,195,65,0,2024-04-15
235,Adlai,55,52,78,185,61,0,2024-04-20
236,Farand,72,60,55,187,62,0,2024-04-17
237,Kandy,96,78,83,257,85,0,2024-04-15
238,Shanie,61,58,67,186,62,0,2024-04-10
239,Marje,86,92,52,230,76,0,2024-04-23
240,Herrick,95,82,89,266,88,0,2024-04-20
241,Thor,62,50,67,179,59,0,2024-04-14
242,Rosaleen,59,79,67,205,68,0,2024-04-16
243,Ring,53,77,57,187,62,0,2024-04-14
244,Reggy,71,99,80,250,83,0,2024-04-11
245,Evangelina,95,73,78,246,82,0,2024-04-21
246,Gal,64,56,98,218,72,0,2024-04-18
247,Dasha,92,60,100,252,84,0,2024-04-10
248,Maggee,53,96,89,238,79,0,2024-04-19
249,Jakob,100,99,56,255,85,0,2024-04-18
250,Julie,77,51,67,195,65,0,2024-04-23
251,Norby,85,53,79,217,72,0,2024-04-21
252,Dani,97,89,82,268,89,0,2024-04-19
253,Marley,83,78,90,251,83,0,2024-04-19
254,Anitra,85,77,72,234,78,0,2024-04-15
255,Vera,52,60,93,205,68,0,2024-04-21
256,Amye,94,81,58,233,77,0,2024-04-20
257,Joyce,80,55,92,227,75,0,2024-04-15
258,Germayne,72,84,84,240,80,0,2024-04-10
259,Danya,99,82,91,272,90,0,2024-04-22
260,Moina,69,51,98,218,72,0,2024-04-22
261,Kimberlee,73,99,58,230,76,0,2024-04-15
262,Stormie,96,83,79,258,86,0,2024-04-23
263,Lyn,61,99,78,238,79,0,2024-04-14
264,Boyce,84,97,64,245,81,0,2024-04-19
265,Francis,77,69,68,214,71,0,2024-04-21
266,Byrann,78,58,78,214,71,0,2024-04-19
267,Dannye,91,70,84,245,81,0,2024-04-13
268,Kaye,53,85,88,226,75,0,2024-04-11
269,Lyon,57,67,82,206,68,0,2024-04-12
270,Hodge,60,71,90,221,73,0,2024-04-12
271,Burgess,98,74,97,269,89,0,2024-04-15
272,Davin,59,88,55,202,67,0,2024-04-16
273,Olly,73,87,76,236,78,0,2024-04-10
274,Wesley,66,95,88,249,83,0,2024-04-10
275,Brittaney,62,75,83,220,73,0,2024-04-21
276,Sisely,74,85,99,258,86,0,2024-04-15
277,Deck,90,96,87,273,91,0,2024-04-11
278,Kevan,53,89,82,224,74,0,2024-04-14
279,Edsel,54,68,72,194,64,0,2024-04-17
280,Alanah,86,91,69,246,82,0,2024-04-23
281,Celka,62,91,77,230,76,0,2024-04-20
282,Claresta,83,66,87,236,78,0,2024-04-23
283,Jeannette,57,88,53,198,66,0,2024-04-20
284,Mala,79,93,90,262,87,0,2024-04-23
285,Randee,57,100,75,232,77,0,2024-04-11
286,Kenn,85,87,53,225,75,0,2024-04-16
287,Zsa zsa,61,62,75,198,66,0,2024-04-15
288,Smitty,65,53,92,210,70,0,2024-04-10
289,Carilyn,77,68,55,200,66,0,2024-04-13
290,Giacinta,64,75,92,231,77,0,2024-04-23
291,Coleman,59,73,75,207,69,0,2024-04-11
292,Bernarr,98,83,68,249,83,0,2024-04-22
293,Phillis,72,89,69,230,76,0,2024-04-11
294,Jo,70,59,95,224,74,0,2024-04-13
295,Rosie,69,61,94,224,74,0,2024-04-17
296,Miof mela,84,86,63,233,77,0,2024-04-10
297,Ranna,63,55,56,174,58,0,2024-04-14
298,Pier,98,81,75,254,84,0,2024-04-16
299,Horatius,78,63,69,210,70,0,2024-04-16
300,Maribel,82,97,69,248,82,0,2024-04-13
301,Annabal,87,70,70,227,75,0,2024-04-11
302,Sybyl,100,98,98,296,98,0,2024-04-18
303,Robin,69,80,53,202,67,0,2024-04-20
304,Zack,50,90,60,200,66,0,2024-04-20
305,Hector,77,93,66,236,78,0,2024-04-18
306,Eldon,100,53,88,241,80,0,2024-04-20
307,Josi,82,96,99,277,92,0,2024-04-11
308,Violante,78,57,53,188,62,0,2024-04-10
309,Kenny,69,59,81,209,69,0,2024-04-11
310,Filberto,50,79,51,180,60,0,2024-04-18
311,Doris,100,73,51,224,74,0,2024-04-10
312,Norman,69,76,67,212,70,0,2024-04-14
313,Gail,82,89,52,223,74,0,2024-04-16
314,Aubine,71,60,73,204,68,0,2024-04-17
315,Flss,92,89,67,248,82,0,2024-04-22
316,Loren,61,52,55,168,56,0,2024-04-21
317,Fallon,70,85,64,219,73,0,2024-04-20
318,April,99,55,93,247,82,0,2024-04-22
319,Amerigo,82,60,97,239,79,0,2024-04-14
320,Arlin,92,96,52,240,80,0,2024-04-13
321,Abba,94,97,55,246,82,0,2024-04-11
322,Amabel,91,61,71,223,74,0,2024-04-20
323,Jaynell,100,88,95,283,94,0,2024-04-13
324,Margaret,66,57,69,192,64,0,2024-04-11
325,Nell,85,86,90,261,87,0,2024-04-21
326,Faythe,73,71,58,202,67,0,2024-04-22
327,Kaleena,97,68,72,237,79,0,2024-04-12
328,Gherardo,84,93,55,232,77,0,2024-04-15
329,Chance,59,84,60,203,67,0,2024-04-11
330,Zedekiah,55,63,60,178,59,0,2024-04-23
331,Cleve,82,95,89,266,88,0,2024-04-16
332,Brenden,94,96,92,282,94,0,2024-04-16
333,Hartwell,71,78,74,223,74,0,2024-04-21
334,Giovanna,91,54,89,234,78,0,2024-04-15
335,Mallory,69,61,91,221,73,0,2024-04-11
336,Netty,95,88,69,252,84,0,2024-04-14
337,Kermy,74,66,91,231,77,0,2024-04-13
338,Burg,92,99,57,248,82,0,2024-04-15
339,Gay,68,83,74,225,75,0,2024-04-14
340,Gilbert,89,59,93,241,80,0,2024-04-10
341,Ambrosi,66,59,62,187,62,0,2024-04-20
342,Urson,78,84,79,241,80,0,2024-04-10
343,Ekaterina,62,97,50,209,69,0,2024-04-22
344,Giana,53,93,71,217,72,0,2024-04-18
345,Carin,93,82,66,241,80,0,2024-04-14
346,Charla,61,83,99,243,81,0,2024-04-14
347,D'arcy,79,53,60,192,64,0,2024-04-19
348,Seumas,62,70,93,225,75,0,2024-04-22
349,Beryl,54,54,68,176,58,0,2024-04-13
350,Ernestus,91,95,76,262,87,0,2024-04-17
351,Dunstan,87,96,77,260,86,0,2024-04-14
352,Hilly,76,83,60,219,73,0,2024-04-17
353,Molli,81,58,53,192,64,0,2024-04-21
354,Cameron,95,63,56,214,71,0,2024-04-11
355,Darsey,71,69,58,198,66,0,2024-04-17
356,Coleen,86,95,76,257,85,0,2024-04-18
357,Sonnnie,94,55,91,240,80,0,2024-04-21
358,Karalynn,92,50,66,208,69,0,2024-04-10
359,Christy,76,52,61,189,63,0,2024-04-20
360,Claudio,60,57,84,201,67,0,2024-04-22
361,Starlin,100,69,77,246,82,0,2024-04-18
362,Emlyn,80,80,78,238,79,0,2024-04-10
363,Arron,77,84,69,230,76,0,2024-04-19
364,Fionnula,72,78,98,248,82,0,2024-04-17
365,Case,99,75,51,225,75,0,2024-04-20
366,Ivie,95,94,60,249,83,0,2024-04-16
367,Ines,84,99,50,233,77,0,2024-04-18
368,Ferrel,85,62,81,228,76,0,2024-04-22
369,Kirsten,63,66,54,183,61,0,2024-04-18
370,Pauly,60,79,88,227,75,0,2024-04-22
371,Ailene,82,55,99,236,78,0,2024-04-17
372,Zorah,94,61,69,224,74,0,2024-04-14
373,Emanuel,60,66,64,190,63,0,2024-04-11
374,Tiffanie,50,78,75,203,67,0,2024-04-11
375,Fredric,84,52,51,187,62,0,2024-04-18
376,Cornall,92,70,71,233,77,0,2024-04-16
377,Julia,73,90,76,239,79,0,2024-04-20
378,Ky,100,70,83,253,84,0,2024-04-17
379,Alix,88,66,72,226,75,0,2024-04-18
380,Koo,65,95,81,241,80,0,2024-04-18
381,Rae,77,89,51,217,72,0,2024-04-12
382,Josefina,77,90,91,258,86,0,2024-04-17
383,Dolf,58,89,73,220,73,0,2024-04-21
384,Andy,99,82,82,263,87,0,2024-04-10
385,Quintana,98,68,74,240,80,0,2024-04-21
386,Ode,90,88,56,234,78,0,2024-04-18
387,Corliss,96,56,92,244,81,0,2024-04-19
388,Mina,88,64,63,215,71,0,2024-04-10
389,Cristi,79,92,55,226,75,0,2024-04-16
390,Worth,92,63,73,228,76,0,2024-04-15
391,Melva,87,79,56,222,74,0,2024-04-15
392,Herculie,79,77,57,213,71,0,2024-04-11
393,Daile,57,56,94,207,69,0,2024-04-23
394,Ramsay,98,93,51,242,80,0,2024-04-11
395,Jazmin,51,85,68,204,68,0,2024-04-18
396,Bernard,98,65,85,248,82,0,2024-04-20
397,Mikey,78,59,78,215,71,0,2024-04-14
398,Hubey,57,87,81,225,75,0,2024-04-20
399,Saloma,93,96,82,271,90,0,2024-04-16
400,Hewie,64,82,64,210,70,0,2024-04-14
401,Gena,50,96,83,229,76,0,2024-04-21
402,Bertha,63,72,58,193,64,0,2024-04-18
403,Hedda,79,65,98,242,80,0,2024-04-11
404,Lea,73,96,82,251,83,0,2024-04-19
405,Sanderson,51,92,61,204,68,0,2024-04-12
406,Devi,79,51,89,219,73,0,2024-04-22
407,Berton,93,80,79,252,84,0,2024-04-20
408,Oliviero,57,70,77,204,68,0,2024-04-18
409,Hayley,100,72,82,254,84,0,2024-04-12
410,Aileen,85,54,79,218,72,0,2024-04-13
411,Lizzy,54,70,75,199,66,0,2024-04-21
412,Brandy,77,91,86,254,84,0,2024-04-10
413,Dimitry,67,83,86,236,78,0,2024-04-15
414,Maribel,59,52,65,176,58,0,2024-04-11
415,Bennie,82,82,90,254,84,0,2024-04-13
416,Giraud,97,62,59,218,72,0,2024-04-15
417,Elva,99,53,96,248,82,0,2024-04-12
418,Maurine,75,86,55,216,72,0,2024-04-19
419,Juana,55,51,75,181,60,0,2024-04-23
420,Laurens,66,96,61,223,74,0,2024-04-10
421,Gavra,83,57,56,196,65,0,2024-04-20
422,Rayner,52,71,91,214,71,0,2024-04-11
423,Bev,80,73,52,205,68,0,2024-04-21
424,Roderic,75,64,80,219,73,0,2024-04-19
425,Tirrell,54,71,79,204,68,0,2024-04-17
426,Aluin,56,97,90,243,81,0,2024-04-15
427,Aurea,100,51,79,230,76,0,2024-04-21
428,Hinze,85,62,87,234,78,0,2024-04-14
429,Granger,85,66,63,214,71,0,2024-04-15
430,Benoite,84,51,89,224,74,0,2024-04-12
431,Mari,85,77,80,242,80,0,2024-04-23
432,Kerwin,83,88,73,244,81,0,2024-04-21
433,Geri,50,94,91,235,78,0,2024-04-12
434,Elicia,99,69,83,251,83,0,2024-04-11
435,Antoinette,65,51,62,178,59,0,2024-04-14
436,Bobbye,77,72,57,206,68,0,2024-04-14
437,Madison,85,69,76,230,76,0,2024-04-19
438,Ange,64,94,80,238,79,0,2024-04-20
439,Tabbie,76,95,85,256,85,0,2024-04-15
440,Neille,84,87,84,255,85,0,2024-04-21
441,Christine,93,97,77,267,89,0,2024-04-22
442,Edsel,52,100,50,202,67,0,2024-04-12
443,Freda,73,54,78,205,68,0,2024-04-12
444,Mariette,84,51,50,185,61,0,2024-04-16
445,Darrelle,52,78,55,185,61,0,2024-04-14
446,Hollie,71,58,86,215,71,0,2024-04-10
447,Justinian,73,51,71,195,65,0,2024-04-17
448,Leeann,96,99,58,253,84,0,2024-04-11
449,Laraine,97,62,69,228,76,0,2024-04-18
450,Paddie,79,51,84,214,71,0,2024-04-17
451,Ethe,53,89,57,199,66,0,2024-04-16
452,Brandea,99,53,69,221,73,0,2024-04-11
453,Sylvester,50,54,97,201,67,0,2024-04-18
454,Karalynn,61,98,94,253,84,0,2024-04-19
455,Raimundo,82,92,89,263,87,0,2024-04-13
456,Valentijn,63,98,63,224,74,0,2024-04-12
457,Horst,93,54,84,231,77,0,2024-04-20
458,Manfred,70,92,66,228,76,0,2024-04-23
459,Iain,51,76,85,212,70,0,2024-04-16
460,Arlin,93,94,60,247,82,0,2024-04-14
461,Lorianna,84,66,60,210,70,0,2024-04-18
462,Gareth,61,100,86,247,82,0,2024-04-21
463,Frannie,87,75,68,230,76,0,2024-04-23
464,Corrie,70,99,59,228,76,0,2024-04-17
465,Sarine,96,89,51,236,78,0,2024-04-11
466,Annabel,55,59,57,171,57,0,2024-04-12
467,Normie,84,97,85,266,88,0,2024-04-23
468,Forrest,63,88,99,250,83,0,2024-04-18
469,Jaquelyn,87,58,82,227,75,0,2024-04-23
470,Aldon,98,99,73,270,90,0,2024-04-23
471,Lusa,91,68,52,211,70,0,2024-04-16
472,Friederike,71,70,75,216,72,0,2024-04-19
473,Meir,52,84,75,211,70,0,2024-04-20
474,Bernette,61,54,100,215,71,0,2024-04-19
475,Eba,86,51,61,198,66,0,2024-04-21
476,Vilma,66,51,58,175,58,0,2024-04-21
477,Andrea,97,72,68,237,79,0,2024-04-13
478,Sheri,86,84,98,268,89,0,2024-04-19
479,Nertie,79,86,56,221,73,0,2024-04-17
480,Dannye,60,57,82,199,66,0,2024-04-17
481,Christiano,88,57,50,195,65,0,2024-04-17
482,Ainsley,55,97,54,206,68,0,2024-04-17
483,Morgun,77,90,66,233,77,0,2024-04-10
484,Dareen,52,64,74,190,63,0,2024-04-19
485,Cyrill,88,60,96,244,81,0,2024-04-17
486,Lauri,80,68,94,242,80,0,2024-04-16
487,Kelley,57,94,65,216,72,0,2024-04-19
488,Cazzie,50,56,58,164,54,0,2024-04-15
489,Aldwin,78,89,51,218,72,0,2024-04-16
490,Warden,69,53,64,186,62,0,2024-04-10
491,Yehudit,50,88,88,226,75,0,2024-04-17
492,Marj,66,54,58,178,59,0,2024-04-15
493,Raymond,82,79,59,220,73,0,2024-04-23
494,Selia,91,69,57,217,72,0,2024-04-14
495,Gifford,57,56,87,200,66,0,2024-04-22
496,Myriam,68,51,66,185,61,0,2024-04-22
497,Jeanette,55,79,81,215,71,0,2024-04-18
498,Simon,71,74,87,232,77,0,2024-04-13
499,Ann-marie,55,96,57,208,69,0,2024-04-17
500,Cale,83,86,86,255,85,0,2024-04-19
501,Vannie,65,56,63,184,61,0,2024-04-20
502,Roxane,71,68,76,215,71,0,2024-04-22
503,Gayler,56,65,55,176,58,0,2024-04-21
504,Dion,80,63,70,213,71,0,2024-04-20
505,Adelina,62,76,50,188,62,0,2024-04-15
506,Issy,51,80,61,192,64,0,2024-04-23
507,Raleigh,55,73,88,216,72,0,2024-04-18
508,Brewer,90,67,98,255,85,0,2024-04-11
509,Keane,73,72,89,234,78,0,2024-04-15
510,Talia,90,59,59,208,69,0,2024-04-13
511,Tracie,53,87,75,215,71,0,2024-04-19
512,Renard,51,94,68,213,71,0,2024-04-18
513,Jocelyn,91,90,51,232,77,0,2024-04-14
514,Othilia,70,64,73,207,69,0,2024-04-10
515,Malinde,99,61,77,237,79,0,2024-04-17
516,Arlie,94,50,77,221,73,0,2024-04-19
517,Taryn,82,81,86,249,83,0,2024-04-22
518,Giustino,81,69,91,241,80,0,2024-04-16
519,Gypsy,73,87,63,223,74,0,2024-04-22
520,Almeta,68,61,92,221,73,0,2024-04-12
521,Alvie,78,65,51,194,64,0,2024-04-20
522,Georgeanne,93,56,98,247,82,0,2024-04-21
523,Dasi,93,59,60,212,70,0,2024-04-14
524,Cindie,95,67,61,223,74,0,2024-04-10
525,Zaria,60,99,94,253,84,0,2024-04-13
526,Job,58,55,59,172,57,0,2024-04-22
527,Terri-jo,68,100,74,242,80,0,2024-04-12
528,Sigismund,58,52,72,182,60,0,2024-04-19
529,Kimball,56,95,56,207,69,0,2024-04-17
530,Florinda,74,69,72,215,71,0,2024-04-15
531,Dean,79,74,52,205,68,0,2024-04-10
532,Ella,100,75,98,273,91,0,2024-04-21
533,Esme,92,86,92,270,90,0,2024-04-16
534,Valeria,59,70,75,204,68,0,2024-04-14
535,Berte,79,58,100,237,79,0,2024-04-14
536,Ewan,95,55,94,244,81,0,2024-04-23
537,Nealon,77,52,85,214,71,0,2024-04-17
538,Ezekiel,76,98,56,230,76,0,2024-04-23
539,Shell,100,70,98,268,89,0,2024-04-18
540,Forest,77,52,57,186,62,0,2024-04-15
541,Oliviero,64,74,98,236,78,0,2024-04-14
542,Jamaal,57,92,53,202,67,0,2024-04-18
543,Link,61,83,53,197,65,0,2024-04-22
544,Albertina,55,88,51,194,64,0,2024-04-19
545,Kessia,94,67,76,237,79,0,2024-04-10
546,Joella,85,98,81,264,88,0,2024-04-14
547,Bambi,97,81,54,232,77,0,2024-04-20
548,Muhammad,82,57,90,229,76,0,2024-04-21
549,Beret,62,69,88,219,73,0,2024-04-23
550,Trescha,92,87,54,233,77,0,2024-04-22
551,Valaree,61,85,55,201,67,0,2024-04-10
552,Godiva,86,88,55,229,76,0,2024-04-22
553,Raddy,80,98,52,230,76,0,2024-04-20
554,Dorree,76,69,73,218,72,0,2024-04-11
555,Xenos,99,74,60,233,77,0,2024-04-21
556,Stephanus,55,71,62,188,62,0,2024-04-12
557,Ingeborg,60,75,55,190,63,0,2024-04-15
558,Ajay,95,83,88,266,88,0,2024-04-18
559,Dagmar,65,62,59,186,62,0,2024-04-20
560,Rodina,85,78,78,241,80,0,2024-04-18
561,Roby,66,85,72,223,74,0,2024-04-12
562,Kiah,88,53,50,191,63,0,2024-04-18
563,Pebrook,71,95,95,261,87,0,2024-04-12
564,Jacynth,70,94,81,245,81,0,2024-04-15
565,Joyous,70,58,68,196,65,0,2024-04-21
566,Liuka,90,88,54,232,77,0,2024-04-13
567,Jolene,92,63,52,207,69,0,2024-04-19
568,Hieronymus,98,73,54,225,75,0,2024-04-11
569,Kimmy,67,56,61,184,61,0,2024-04-10
570,Blythe,89,83,92,264,88,0,2024-04-11
571,Dorice,81,60,65,206,68,0,2024-04-17
572,Valencia,83,58,62,203,67,0,2024-04-12
573,Tally,71,71,78,220,73,0,2024-04-22
574,Gratia,62,83,94,239,79,0,2024-04-11
575,Manfred,75,80,97,252,84,0,2024-04-16
576,Cacilie,68,95,62,225,75,0,2024-04-11
577,Dolph,77,91,72,240,80,0,2024-04-14
578,Laverne,84,59,72,215,71,0,2024-04-22
579,Sebastien,93,66,72,231,77,0,2024-04-12
580,Gunilla,67,93,97,257,85,0,2024-04-15
581,Anthony,50,95,74,219,73,0,2024-04-11
582,Rick,52,100,75,227,75,0,2024-04-22
583,Clio,54,95,52,201,67,0,2024-04-20
584,Biddie,78,68,69,215,71,0,2024-04-15
585,Huntlee,75,86,98,259,86,0,2024-04-11
586,Ardath,50,83,93,226,75,0,2024-04-22
587,Ferrell,91,86,66,243,81,0,2024-04-18
588,Gillie,70,99,95,264,88,0,2024-04-12
589,Tommy,66,83,97,246,82,0,2024-04-12
590,Gerald,50,50,78,178,59,0,2024-04-11
591,Steward,99,95,54,248,82,0,2024-04-13
592,Kenton,52,56,94,202,67,0,2024-04-23
593,Chad,77,56,81,214,71,0,2024-04-16
594,Isa,100,84,87,271,90,0,2024-04-21
595,Stillmann,99,83,60,242,80,0,2024-04-13
596,Brenna,81,98,50,229,76,0,2024-04-21
597,Gratiana,77,93,75,245,81,0,2024-04-13
598,Loy,89,99,54,242,80,0,2024-04-18
599,Gussie,97,64,95,256,85,0,2024-04-16
600,Hailee,86,82,71,239,79,0,2024-04-21
601,Bev,74,94,87,255,85,0,2024-04-19
602,Zaria,68,80,86,234,78,0,2024-04-18
603,Robin,62,76,69,207,69,0,2024-04-21
604,Lorelei,65,61,96,222,74,0,2024-04-19
605,Sarita,83,85,52,220,73,0,2024-04-15
606,Riane,77,50,66,193,64,0,2024-04-19
607,Noby,94,61,92,247,82,0,2024-04-22
608,Anthony,64,95,90,249,83,0,2024-04-23
609,Norry,68,94,59,221,73,0,2024-04-23
610,Jany,57,66,75,198,66,0,2024-04-14
611,Thane,55,73,92,220,73,0,2024-04-15
612,Mella,61,100,57,218,72,0,2024-04-12
613,Gloriane,91,91,78,260,86,0,2024-04-11
614,Feliza,60,93,81,234,78,0,2024-04-19
615,Georgeta,51,72,77,200,66,0,2024-04-11
616,Cassius,57,58,59,174,58,0,2024-04-21
617,Dixie,75,89,65,229,76,0,2024-04-14
618,Constantino,87,89,66,242,80,0,2024-04-14
619,Lyndy,54,59,70,183,61,0,2024-04-17
620,Kessia,96,85,88,269,89,0,2024-04-23
621,Harlan,90,61,98,249,83,0,2024-04-15
622,Clementius,57,70,62,189,63,0,2024-04-11
623,Sena,70,65,75,210,70,0,2024-04-17
624,Ruby,87,89,78,254,84,0,2024-04-15
625,Kliment,82,65,72,219,73,0,2024-04-14
626,Darren,93,53,88,234,78,0,2024-04-19
627,Alena,72,95,89,256,85,0,2024-04-19
628,Katy,70,99,64,233,77,0,2024-04-11
629,Ariella,67,72,69,208,69,0,2024-04-23
630,Nanny,97,59,61,217,72,0,2024-04-14
631,Tiebold,63,58,98,219,73,0,2024-04-15
632,Meggie,95,90,54,239,79,0,2024-04-13
633,Yuri,81,56,81,218,72,0,2024-04-21
634,Neddie,67,54,64,185,61,0,2024-04-21
635,Cherry,79,63,51,193,64,0,2024-04-20
636,Brietta,98,61,58,217,72,0,2024-04-16
637,Ranique,55,61,87,203,67,0,2024-04-19
638,Valentijn,97,74,97,268,89,0,2024-04-17
639,Vere,74,54,88,216,72,0,2024-04-22
640,Dorelia,75,77,53,205,68,0,2024-04-10
641,Clovis,97,83,100,280,93,0,2024-04-22
642,Lilian,69,94,87,250,83,0,2024-04-10
643,Paulette,62,86,93,241,80,0,2024-04-11
644,Danny,95,89,82,266,88,0,2024-04-17
645,Del,55,86,96,237,79,0,2024-04-11
646,Olvan,53,88,89,230,76,0,2024-04-22
647,Norma,70,56,52,178,59,0,2024-04-23
648,Susanetta,90,64,75,229,76,0,2024-04-10
649,Fidelio,52,72,92,216,72,0,2024-04-13
650,Josephine,81,57,95,233,77,0,2024-04-13
651,Flynn,77,79,60,216,72,0,2024-04-18
652,Ricki,64,91,74,229,76,0,2024-04-14
653,Yasmin,89,82,98,269,89,0,2024-04-13
654,Davita,72,71,61,204,68,0,2024-04-20
655,Loreen,59,74,67,200,66,0,2024-04-17
656,Ellary,81,90,58,229,76,0,2024-04-10
657,Corina,85,68,94,247,82,0,2024-04-11
658,Daryn,96,68,90,254,84,0,2024-04-13
659,Alisander,89,84,92,265,88,0,2024-04-15
660,Lauralee,54,70,53,177,59,0,2024-04-16
661,Mort,95,92,100,287,95,0,2024-04-14
662,Jonis,66,63,95,224,74,0,2024-04-16
663,Shell,64,59,99,222,74,0,2024-04-11
664,Brianne,73,63,50,186,62,0,2024-04-14
665,Dar,51,73,83,207,69,0,2024-04-19
666,Walden,78,50,55,183,61,0,2024-04-13
667,Selig,71,52,93,216,72,0,2024-04-15
668,Knox,66,99,70,235,78,0,2024-04-10
669,Tedra,68,80,55,203,67,0,2024-04-20
670,Rennie,66,96,57,219,73,0,2024-04-11
671,Nat,72,54,93,219,73,0,2024-04-11
672,Morley,58,50,55,163,54,0,2024-04-17
673,Waverly,76,54,55,185,61,0,2024-04-17
674,Dorolisa,68,84,89,241,80,0,2024-04-21
675,Hamnet,64,62,65,191,63,0,2024-04-16
676,Durand,64,91,91,246,82,0,2024-04-15
677,Suzette,74,55,76,205,68,0,2024-04-21
678,Jere,87,53,86,226,75,0,2024-04-15
679,Miller,96,72,59,227,75,0,2024-04-10
680,Estrellita,63,66,62,191,63,0,2024-04-20
681,Meta,99,62,96,257,85,0,2024-04-14
682,Danya,50,50,50,150,50,0,2024-04-12
683,Midge,68,74,77,219,73,0,2024-04-13
684,Marcia,64,50,86,200,66,0,2024-04-11
685,Felicio,55,81,74,210,70,0,2024-04-20
686,Elbert,61,60,72,193,64,0,2024-04-21
687,Brenda,69,67,98,234,78,0,2024-04-16
688,Lazaro,80,59,86,225,75,0,2024-04-19
689,Coralie,52,92,59,203,67,0,2024-04-19
690,Cordy,73,65,55,193,64,0,2024-04-15
691,Baryram,99,61,89,249,83,0,2024-04-19
692,Byran,92,57,51,200,66,0,2024-04-19
693,Carmon,95,57,83,235,78,0,2024-04-19
694,Whitby,65,55,74,194,64,0,2024-04-13
695,Peg,78,50,68,196,65,0,2024-04-13
696,Mommy,56,64,74,194,64,0,2024-04-10
697,Maribel,89,76,87,252,84,0,2024-04-10
698,Burke,95,86,56,237,79,0,2024-04-19
699,Goldie,75,99,100,274,91,0,2024-04-16
700,Alexandre,67,68,81,216,72,0,2024-04-23
701,Gregg,53,93,67,213,71,0,2024-04-11
702,Winn,65,88,61,214,71,0,2024-04-13
703,Silvio,59,64,77,200,66,0,2024-04-23
704,Marcy,55,60,94,209,69,0,2024-04-15
705,Bunnie,60,86,92,238,79,0,2024-04-21
706,Lucio,83,77,53,213,71,0,2024-04-22
707,Elspeth,74,75,90,239,79,0,2024-04-16
708,Cherianne,59,62,79,200,66,0,2024-04-12
709,Kippy,85,53,57,195,65,0,2024-04-22
710,Jewelle,94,68,86,248,82,0,2024-04-22
711,Zacharie,90,62,76,228,76,0,2024-04-22
712,Erda,71,95,75,241,80,0,2024-04-15
713,Rosalind,51,87,53,191,63,0,2024-04-16
714,Aigneis,67,94,78,239,79,0,2024-04-19
715,Fairleigh,96,97,76,269,89,0,2024-04-12
716,Emelda,52,56,100,208,69,0,2024-04-23
717,Ulberto,71,52,79,202,67,0,2024-04-18
718,Saidee,77,99,59,235,78,0,2024-04-17
719,Devonna,77,64,67,208,69,0,2024-04-21
720,Reagan,55,100,96,251,83,0,2024-04-14
721,Dorian,73,93,68,234,78,0,2024-04-11
722,Babara,55,76,96,227,75,0,2024-04-16
723,Star,71,87,99,257,85,0,2024-04-15
724,Jayne,51,99,60,210,70,0,2024-04-22
725,Niall,81,70,85,236,78,0,2024-04-16
726,Louis,98,97,55,250,83,0,2024-04-11
727,Farrel,76,70,64,210,70,0,2024-04-16
728,Angel,59,83,100,242,80,0,2024-04-16
729,Wakefield,54,96,77,227,75,0,2024-04-10
730,Kalinda,98,93,72,263,87,0,2024-04-21
731,Reginald,87,91,59,237,79,0,2024-04-22
732,Corri,58,61,53,172,57,0,2024-04-14
733,Uta,56,71,56,183,61,0,2024-04-16
734,Sylvia,83,98,58,239,79,0,2024-04-12
735,Lucila,57,75,82,214,71,0,2024-04-12
736,Analise,95,71,69,235,78,0,2024-04-18
737,Urson,87,84,80,251,83,0,2024-04-23
738,Noelyn,70,70,62,202,67,0,2024-04-21
739,Sayre,55,99,58,212,70,0,2024-04-17
740,Juliann,86,68,73,227,75,0,2024-04-17
741,Olenka,82,59,96,237,79,0,2024-04-16
742,Balduin,61,55,55,171,57,0,2024-04-20
743,Evelina,90,70,72,232,77,0,2024-04-23
744,Marlo,89,84,93,266,88,0,2024-04-21
745,Duff,90,55,71,216,72,0,2024-04-13
746,Nobie,75,79,83,237,79,0,2024-04-12
747,Robinetta,70,83,77,230,76,0,2024-04-14
748,Reine,94,54,58,206,68,0,2024-04-22
749,Otis,98,72,96,266,88,0,2024-04-13
750,Benn,75,58,59,192,64,0,2024-04-21
751,Whitaker,79,64,86,229,76,0,2024-04-12
752,Raymond,80,92,83,255,85,0,2024-04-23
753,Gwenette,91,99,80,270,90,0,2024-04-16
754,Grannie,65,52,54,171,57,0,2024-04-21
755,Bird,58,92,86,236,78,0,2024-04-13
756,Mei,96,70,95,261,87,0,2024-04-23
757,Cleo,78,54,96,228,76,0,2024-04-20
758,Rivkah,100,79,58,237,79,0,2024-04-23
759,Mirella,62,76,60,198,66,0,2024-04-19
760,Harrison,58,61,62,181,60,0,2024-04-22
761,Daphna,66,63,86,215,71,0,2024-04-13
762,Lani,57,65,94,216,72,0,2024-04-13
763,Kamillah,72,80,76,228,76,0,2024-04-15
764,Dillie,52,56,56,164,54,0,2024-04-12
765,Marilyn,83,86,56,225,75,0,2024-04-13
766,Toinette,65,92,75,232,77,0,2024-04-22
767,Marijo,79,91,68,238,79,0,2024-04-15
768,Aristotle,97,81,84,262,87,0,2024-04-15
769,Aylmar,84,51,65,200,66,0,2024-04-22
770,Davide,82,90,90,262,87,0,2024-04-17
771,Renault,67,91,92,250,83,0,2024-04-21
772,Barney,81,85,72,238,79,0,2024-04-11
773,Jacqui,93,67,92,252,84,0,2024-04-13
774,Dun,88,72,84,244,81,0,2024-04-10
775,Car,63,72,62,197,65,0,2024-04-15
776,Darrin,98,74,56,228,76,0,2024-04-11
777,Renie,54,62,55,171,57,0,2024-04-13
778,Farah,70,53,92,215,71,0,2024-04-21
779,Jannel,54,55,51,160,53,0,2024-04-21
780,Carlota,51,65,59,175,58,0,2024-04-17
781,Miles,81,74,79,234,78,0,2024-04-21
782,Hal,87,85,79,251,83,0,2024-04-21
783,La verne,54,98,65,217,72,0,2024-04-13
784,Pryce,83,79,89,251,83,0,2024-04-19
785,Lorelle,93,86,93,272,90,0,2024-04-16
786,Jacki,91,98,64,253,84,0,2024-04-20
787,Nikkie,84,75,65,224,74,0,2024-04-14
788,Van,96,92,90,278,92,0,2024-04-15
789,Charmane,98,62,69,229,76,0,2024-04-22
790,Elinore,75,56,93,224,74,0,2024-04-22
791,Thatcher,85,61,62,208,69,0,2024-04-11
792,Rice,62,64,55,181,60,0,2024-04-21
793,Wendall,94,62,80,236,78,0,2024-04-21
794,Kerry,75,88,90,253,84,0,2024-04-20
795,Mort,96,89,78,263,87,0,2024-04-10
796,Sonnie,85,74,92,251,83,0,2024-04-14
797,Salomi,87,72,62,221,73,0,2024-04-10
798,Zed,53,66,77,196,65,0,2024-04-19
799,Ollie,65,62,92,219,73,0,2024-04-23
800,Esme,77,75,93,245,81,0,2024-04-16
801,Obadiah,57,56,70,183,61,0,2024-04-21
802,Kitty,91,70,52,213,71,0,2024-04-21
803,Bartram,91,56,83,230,76,0,2024-04-14
804,Johan,65,65,50,180,60,0,2024-04-12
805,Mab,96,84,98,278,92,0,2024-04-21
806,Wendi,60,61,92,213,71,0,2024-04-21
807,Sybil,89,90,91,270,90,0,2024-04-11
808,Karee,73,56,56,185,61,0,2024-04-22
809,Shane,80,64,88,232,77,0,2024-04-13
810,Sybyl,83,52,57,192,64,0,2024-04-21
811,Victoria,97,78,50,225,75,0,2024-04-23
812,Marcus,73,53,96,222,74,0,2024-04-23
813,Moina,55,79,51,185,61,0,2024-04-17
814,Kathe,54,52,58,164,54,0,2024-04-13
815,Peggi,74,75,68,217,72,0,2024-04-12
816,Brenn,56,75,95,226,75,0,2024-04-16
817,George,100,64,81,245,81,0,2024-04-15
818,Lynea,88,65,98,251,83,0,2024-04-14
819,Leticia,93,84,93,270,90,0,2024-04-19
820,Cayla,70,99,62,231,77,0,2024-04-21
821,Farr,73,63,86,222,74,0,2024-04-18
822,Chastity,50,73,76,199,66,0,2024-04-11
823,Murdoch,92,64,76,232,77,0,2024-04-12
824,Isis,95,80,61,236,78,0,2024-04-14
825,Nathanial,97,95,52,244,81,0,2024-04-22
826,Caroljean,88,92,79,259,86,0,2024-04-23
827,Nil,57,82,54,193,64,0,2024-04-16
828,Holly-anne,74,69,54,197,65,0,2024-04-18
829,Don,57,55,60,172,57,0,2024-04-21
830,Cordi,95,70,94,259,86,0,2024-04-16
831,Cleo,96,53,76,225,75,0,2024-04-15
832,Mathilda,95,66,100,261,87,0,2024-04-20
833,Godfree,74,62,72,208,69,0,2024-04-15
834,Kennedy,100,60,70,230,76,0,2024-04-21
835,Vance,78,89,67,234,78,0,2024-04-11
836,Randie,61,81,88,230,76,0,2024-04-15
837,Rubetta,94,68,85,247,82,0,2024-04-20
838,Bee,59,78,83,220,73,0,2024-04-20
839,Leila,71,85,63,219,73,0,2024-04-11
840,Laural,55,67,62,184,61,0,2024-04-10
841,Roshelle,98,81,74,253,84,0,2024-04-17
842,Royall,93,53,73,219,73,0,2024-04-13
843,Winonah,88,90,96,274,91,0,2024-04-16
844,Bennie,83,92,67,242,80,0,2024-04-14
845,Lyda,80,85,53,218,72,0,2024-04-10
846,Hana,85,69,51,205,68,0,2024-04-20
847,Culver,72,79,97,248,82,0,2024-04-13
848,Rem,59,78,51,188,62,0,2024-04-19
849,Iorgo,61,88,81,230,76,0,2024-04-12
850,Nedda,73,98,87,258,86,0,2024-04-19
851,Madge,61,87,50,198,66,0,2024-04-19
852,Tiphanie,70,81,66,217,72,0,2024-04-11
853,Bryana,58,75,93,226,75,0,2024-04-16
854,Faustina,93,97,95,285,95,0,2024-04-12
855,Kilian,73,77,67,217,72,0,2024-04-22
856,Sibyl,78,51,87,216,72,0,2024-04-13
857,Addie,55,99,66,220,73,0,2024-04-16
858,Mariann,94,60,96,250,83,0,2024-04-20
859,Ryann,67,56,73,196,65,0,2024-04-11
860,Isador,83,71,88,242,80,0,2024-04-12
861,Dory,90,73,77,240,80,0,2024-04-11
862,Janey,71,96,83,250,83,0,2024-04-12
863,Lemmie,85,84,69,238,79,0,2024-04-14
864,Nerte,88,61,91,240,80,0,2024-04-11
865,Hadrian,74,79,54,207,69,0,2024-04-23
866,Rowney,54,54,67,175,58,0,2024-04-22
867,Cayla,94,79,85,258,86,0,2024-04-20
868,Milty,57,86,86,229,76,0,2024-04-17
869,Odette,88,50,68,206,68,0,2024-04-16
870,Guss,89,59,98,246,82,0,2024-04-22
871,Bryna,96,65,82,243,81,0,2024-04-20
872,Joy,88,57,75,220,73,0,2024-04-20
873,Winifred,71,71,74,216,72,0,2024-04-20
874,Kassi,85,88,62,235,78,0,2024-04-20
875,Nelie,69,96,69,234,78,0,2024-04-19
876,Jeannette,98,58,91,247,82,0,2024-04-20
877,Domingo,81,99,93,273,91,0,2024-04-23
878,Theodore,70,70,98,238,79,0,2024-04-11
879,Aggie,73,95,62,230,76,0,2024-04-21
880,Orel,98,57,86,241,80,0,2024-04-22
881,Lindi,55,68,69,192,64,0,2024-04-15
882,Concettina,77,64,79,220,73,0,2024-04-22
883,Sigvard,93,78,92,263,87,0,2024-04-12
884,Enoch,76,68,100,244,81,0,2024-04-14
885,Butch,59,87,52,198,66,0,2024-04-14
886,Pryce,71,67,61,199,66,0,2024-04-19
887,Ludovico,50,92,51,193,64,0,2024-04-20
888,Georgie,94,63,62,219,73,0,2024-04-19
889,Dina,86,77,56,219,73,0,2024-04-16
890,Charmion,88,94,53,235,78,0,2024-04-21
891,Holmes,67,65,63,195,65,0,2024-04-14
892,Bobina,56,89,78,223,74,0,2024-04-23
893,Armando,84,63,65,212,70,0,2024-04-23
894,Arvie,75,53,72,200,66,0,2024-04-13
895,Yoko,76,81,81,238,79,0,2024-04-14
896,Antoine,56,74,62,192,64,0,2024-04-20
897,Ethelbert,85,99,72,256,85,0,2024-04-18
898,Magdaia,52,58,62,172,57,0,2024-04-11
899,Lavinie,73,72,68,213,71,0,2024-04-10
900,Leoline,92,76,73,241,80,0,2024-04-21
901,Vassili,98,59,83,240,80,0,2024-04-12
902,Eugenio,92,80,68,240,80,0,2024-04-23
903,Gabey,62,79,72,213,71,0,2024-04-10
904,Marve,70,90,55,215,71,0,2024-04-23
905,Patsy,92,93,95,280,93,0,2024-04-13
906,Tova,62,62,74,198,66,0,2024-04-17
907,Phillis,86,83,61,230,76,0,2024-04-15
908,Lissy,92,79,97,268,89,0,2024-04-13
909,Theodosia,68,78,91,237,79,0,2024-04-17
910,Fionna,97,96,62,255,85,0,2024-04-18
911,Olympe,59,85,81,225,75,0,2024-04-16
912,Ethyl,63,79,93,235,78,0,2024-04-14
913,Vanya,84,72,99,255,85,0,2024-04-12
914,Walther,90,96,61,247,82,0,2024-04-21
915,Phaedra,58,97,82,237,79,0,2024-04-16
916,Cherise,93,74,97,264,88,0,2024-04-22
917,Keriann,85,55,93,233,77,0,2024-04-20
918,Faun,72,51,72,195,65,0,2024-04-17
919,Britt,100,80,75,255,85,0,2024-04-14
920,Knox,93,58,84,235,78,0,2024-04-19
921,Karlik,64,92,72,228,76,0,2024-04-11
922,Eloisa,71,80,92,243,81,0,2024-04-20
923,Kare,71,61,62,194,64,0,2024-04-19
924,Leila,72,56,60,188,62,0,2024-04-10
925,Georgina,69,94,88,251,83,0,2024-04-18
926,Vinnie,94,53,54,201,67,0,2024-04-12
927,Herb,57,64,96,217,72,0,2024-04-14
928,Wylie,67,96,68,231,77,0,2024-04-10
929,Lauri,74,70,91,235,78,0,2024-04-22
930,Mildrid,57,71,51,179,59,0,2024-04-10
931,Hube,55,57,64,176,58,0,2024-04-11
932,Tobye,85,50,73,208,69,0,2024-04-11
933,Joe,66,76,68,210,70,0,2024-04-13
934,Lowell,72,98,52,222,74,0,2024-04-19
935,Clyde,62,64,88,214,71,0,2024-04-19
936,Brittani,96,77,56,229,76,0,2024-04-12
937,Conni,97,82,86,265,88,0,2024-04-17
938,Nanci,69,71,82,222,74,0,2024-04-13
939,Lebbie,75,100,97,272,90,0,2024-04-19
940,Nikaniki,97,74,53,224,74,0,2024-04-21
941,Chaddie,60,58,82,200,66,0,2024-04-15
942,Faustine,81,79,74,234,78,0,2024-04-22
943,Marney,92,90,78,260,86,0,2024-04-17
944,George,89,79,77,245,81,0,2024-04-15
945,Allsun,50,81,82,213,71,0,2024-04-21
946,Ardyce,53,79,74,206,68,0,2024-04-21
947,Cleveland,75,68,69,212,70,0,2024-04-23
948,Frederich,86,64,75,225,75,0,2024-04-23
949,Bradly,82,74,92,248,82,0,2024-04-19
950,Susy,96,57,99,252,84,0,2024-04-11
951,Cherianne,90,68,85,243,81,0,2024-04-22
952,Colver,85,78,82,245,81,0,2024-04-16
953,Judie,68,79,91,238,79,0,2024-04-12
954,Enrica,54,53,53,160,53,0,2024-04-11
955,Alisander,89,61,55,205,68,0,2024-04-18
956,Arnold,96,86,100,282,94,0,2024-04-21
957,Chiquia,68,95,83,246,82,0,2024-04-22
958,Alessandro,54,76,61,191,63,0,2024-04-19
959,Kristine,53,96,84,233,77,0,2024-04-20
960,Theresina,54,55,59,168,56,0,2024-04-18
961,Alia,67,68,94,229,76,0,2024-04-10
962,Elvis,100,58,94,252,84,0,2024-04-23
963,Constance,80,70,82,232,77,0,2024-04-18
964,Elias,65,96,61,222,74,0,2024-04-23
965,Sallie,56,60,90,206,68,0,2024-04-20
966,Garik,100,92,82,274,91,0,2024-04-15
967,Fallon,80,50,92,222,74,0,2024-04-21
968,Ross,60,95,74,229,76,0,2024-04-14
969,Hannis,61,71,70,202,67,0,2024-04-15
970,Zachery,66,72,67,205,68,0,2024-04-17
971,Muhammad,81,63,82,226,75,0,2024-04-15
972,Jocelin,81,64,79,224,74,0,2024-04-21
973,Brewer,93,84,57,234,78,0,2024-04-17
974,Chuck,71,71,69,211,70,0,2024-04-15
975,Cassey,53,84,52,189,63,0,2024-04-13
976,Frederico,74,84,86,244,81,0,2024-04-15
977,Ezechiel,86,84,69,239,79,0,2024-04-11
978,Gerrard,70,98,85,253,84,0,2024-04-13
979,Luther,100,53,73,226,75,0,2024-04-17
980,Ollie,82,60,56,198,66,0,2024-04-13
981,Hyacinthie,52,58,57,167,55,0,2024-04-13
982,Ev,92,54,66,212,70,0,2024-04-19
983,Lurline,59,55,51,165,55,0,2024-04-12
984,Thurston,57,65,85,207,69,0,2024-04-10
985,Rochell,69,54,92,215,71,0,2024-04-17
986,Merrel,97,88,77,262,87,0,2024-04-16
987,Redford,51,96,50,197,65,0,2024-04-14
988,Claudia,89,52,58,199,66,0,2024-04-23
989,Jade,79,79,85,243,81,0,2024-04-15
990,Kristyn,75,50,79,204,68,0,2024-04-22
991,Scott,54,67,91,212,70,0,2024-04-23
992,Cammy,84,50,74,208,69,0,2024-04-23
993,D'arcy,88,85,55,228,76,0,2024-04-13
994,Zabrina,96,77,84,257,85,0,2024-04-12
995,Rebekkah,98,78,82,258,86,0,2024-04-15
996,Sloan,65,77,70,212,70,0,2024-04-16
997,Flint,96,63,99,258,86,0,2024-04-20
998,Robbi,95,73,52,220,73,0,2024-04-13
999,Ruggiero,66,93,84,243,81,0,2024-04-11
1000,Margaux,75,53,52,180,60,0,2024-04-13
